----------------------
/..................../
/.......dd.........../
/............cc....../
/..................../
/aaaaa..........aaaaa/
/..................../
/.......bbbb........./
/..................../
/............eee...../
/......fff.........../
/................hhhh/
/g...............hhhh/
______________________